NO ./img/north.xpm
SO ./img/south.xpm
WE ./img/west.xpm
EA ./img/east.xpm
F 25,48,21
C 46,104,155

111111111111111111
100D00000010000001
101110000000000001
101110000111111111
111100000100D0101
1110100001000D111
100000000000001
111010100010001
1111101111000111
   10011101N001
   111111111111
