NO ./img/north.xpm
SO ./img/south.xpm
WE ./img/west.xpm
EA ./img/east.xpm
F 25,48,21
C 46,104,155

11111111111  
10000S00001
10000000001
10000000001
10000000001
11111111111