F 100,100,26
NO      ./img/crystal_wall.xpm

     SO      ./img/greyface_wall.xpm    
WE ./img/brickmoss_wall.xpm
EA ./img/wooden_box.xpm

C 56,244,0            

      
      
        1111111111111111111111111
        1000000000110000010000001
        1011000001110000000000001
        1001000000000000010000001
111111111011000001110000000000001
10000000001100000111000011111111111111111111111111111
111100111111110111100000100001
111100111111110111010100100001
110000001101010111000000100W01
100000000000000000000000000001
100000000000000011010100010001
1100000111010101111101111101111
10010111 1110101 1011110111111
11111111 1111111 111111111111
11
1
    
    11




